空空空空空空空空空空空空空
空空草草草草草草草草空空空
空空空空空空空空空空空空空
空空空空空空空空空空空空空
空空水水水水水水水水空空空
空空空空空空空空空空空空空
空空铁铁铁铁铁铁铁铁空空空
空空空空空空空空空空空空空
空空空空空空空空空空空空空
空空砖砖砖砖砖砖砖砖空空空
空空空空空空空空空空空空空
空空空空空空空空空空空空空
空空空空空空空空空主空空空